X.B..B.......B..B.X
...................
B....B........B...B
.......B.B.B.......
......B.W.W.B......
B.B..B.......B..B.B
....B....W....B....
...B....W.W....B...
....W..W.W.W..W....
...B..W.WkW.W..B...
....W..W.W.W..W....
...B....W.W....B...
....B....W....B....
B.B..B.......B..B.B
......B.W.W.B......
.......B.B.B.......
B....B........B...B
...................
X.B..B.......B..B.X
