...bbb...
....b....
....W....
b...W...b
bbWWkWWbb
b...W...b
....W....
....b....
...bbb...
