X...BBBBB...X
......B......
.............
B.....W.....B
B.....W.....B
BB.WWWkWWW.BB
B.....W.....B
B.....W.....B
.............
......B......
X...BBBBB...X
