X...BBB...X
....B.B....
.....B.....
.....W.....
BB..WWW..BB
B.BWWkWWB.B
BB..WWW..BB
.....W.....
.....B.....
....B.B....
X...BBB...X
